R 800 800
NO textures/mossy.XPM
SO textures/mossy.XPM
EA textures/mossy.XPM
WE textures/mossy.XPM
S ./textures/greenlight.XPM
C 255,200,160
F 122,122,122

111111111
100020001
100000001
1200N0021
100000001
100020001
111111111